111111111111111111111
10000000000000000E001
100000000000000001111
100000000000000000011
100000000000000000011
100000000000000000011
100000000000000001111
1000P0000000000000001
111111111111111111111