111111111111111111111
1000011000000000000E1
10000C100001110001111
100000000000000000011
100011100000000000011
1000000000C0000000011
100000100000111001111
1000P0000000000000C01
111111111111111111111
