111111111111111111111
1000C000000000000E001
100000000000000001111
100000000000000000011
1000000000C0000000011
100000000000000000011
100000000000000001111
1000P0000000000000001
111111111111111111111